11 6
___________
+WR----B_F*
|---_G_---!
+BN_---___*
|----_----!
+_M__B_R__*
