10 6
__________
|----_FW_*
+R_G__---!
+RB----_B*
|---__---!
+_M_B_R__*
