12 6
____________
|-R__---_B-!
+R-!--RM|-B*
|-R*NB--+B-!
+R-!W--F|-B*
+__*R__B+__*
